Ni no Kuni Wrath of the White Witch™ Remastered  | Ni no Kuni A ira da Bruxa Branca™ Remastered


1 até 5541 = Daniel

5542 até 11082 = Jonathan(Finalizado e inserido)

11.083 até 16.624 = Diego(Finalizado e inserido)

16.625 até 22.165 = Jorge

22.166 até 27.706  = Vinicius

27.707 até 33.247 = Sergio(Finalizado e inserido)

33.248 até 38.783 = Lucas(Finalizado e inserido)



Wiki do jogo

https://ninokuni.fandom.com/wiki/Ni_no_Kuni_Wiki

Nome
*Hickory Dock = Sugestões: Tapo Gigio
Dark Djinn = Mago Sombrio



Adaptação de termos:

Cat's Cradle = Cama de Gato ou Berço do Gato, é uma pousada do jogo.
Solutions Swift = Soluções Rápidas (nome de uma loja no game)
Telling Stone = Pode ser mesmo Pedra Reveladora, ela informa as estaticas do Oliveir e da dicas.
Spring Lock =  pode ser Abra-Tudo.  E um feitiço para abrir báus e portas trancadas.
Guilder  = Dinheiro do jogo, deixar como está.
familiar = deixar como está, seria algo que você doma ele, e pode evoluir, parecido com Pokémon.
Deep Dark Wood =  Floresta Tenebrosa Oculta
Old Smoky = Pico Fumegante
brokenhearted =  Coração Partido, e uma magia negra que foi lançada em algumas pessoas.
Mornstar = Nome de um varinha lendária, deixar igual.
Cowlipha = Vacalifa(retirei do espanhol)
Moojesty = Moojestade (Usei nesse termo)
Bovinity = Bovinidade
Senhorita Leila (miss Leila) = Dona Leila
Your Radiance = Vossa Luminosidade
Fairyground = Recanto das Fadas
Cavity Club = Clube Bocalarga
Clarion = Triflauta
pipsqueak = miniatura
Cloud Sweeper = Varredora de Nuvens(Uma vassoura que serve como veiculo)
Meowjesty = Miaujestade
Soulsnare = Armadilha de Almas
Vileheart = Malcoração
Smiley and Surly - Hilário e Rabugento
Nevermore = Semvolta
Pure-Hearted One = Aquele de Coração Puro
Ervilha=Corrigir para Pea
maná=Corrigir para mana
Iron Wyvern = Serpe de Ferro
Nazcaä = Nazcaa "Não pode usar a com trema por causa da fonte que foi alterada"
Zodiarchs=Zodiarcas
Galo=Gallus
spell=feitiço
bunting = chorão
Sky Tree = Árvore Celestial
Solosseum = Soliseu
Salomão = Solomon
*mun= Estou pensando em Colocar "maninho"
Flipping heck = Caramba
Compendium = Bestiário
pickpocket's pistol = pistola de batedor
Bottomless Bag = Bolsa sem Fundo
alchemical formula = receita alquímica
Wizard's Companion = Companheiro do Mago
dealer = crupiê
waystone = pedra da salvação
Creature Cage = Gaiola de Criaturas
Familiar Retreat = Refúgio dos Familiares
Miracle Move = Movimento Milagroso
Encosta Abandonada = Castaway

Feitiços
Rejuvenate = Renovar
Breach Time = Quebra Temporal
Unleash = Invocar
Mornstar! = Estrela da Alvorada
Cloudburst = Dilúvio
Sanckify = Purificar
Healing Touch = Toque de Cura
Fireball = Bola de Fogo
Take Heart = Pegar o Coração
Give Heart = Dar o Coração

